o,o,o,o,l,l,l,l,l,l,l,l,l,l,l
o,o,o,o,l,l,l,l,o,o,l,l,l,l,l
o,l,l,l,l,l,l,l,o,l,l,l,l,l,l
l,l,l,l,o,o,l,l,l,l,l,l,l,l,l
l,l,l,l,o,o,l,l,l,l,l,l,l,l,l
l,l,l,l,o,o,l,o,l,l,l,l,l,l,l
l,l,l,o,o,o,o,o,l,l,l,l,l,l,l
l,l,l,o,o,o,o,o,o,o,o,l,l,l,l
l,l,l,l,l,l,o,o,o,o,o,l,l,l,l
l,l,l,l,l,l,o,o,l,l,l,l,l,l,l
l,l,l,l,l,l,l,o,l,l,l,l,l,l,l
l,l,l,o,l,l,l,l,l,l,l,l,l,l,l
l,l,l,o,l,l,l,l,l,l,l,o,o,o,l
l,l,l,l,l,l,l,l,l,l,l,l,o,o,l
l,l,l,l,l,l,o,l,l,l,l,l,l,l,l